{
    "default": 0,
    "output_type": "integer",
    "map": {
        "HA1": {
            "122": 1,
            "124": 1,
            "126": 1,
            "130": 1,
            "131": 1,
            "132": 1,
            "133": 1,
            "135": 1,
            "137": 1,
            "138": 1,
            "140": 1,
            "142": 1,
            "143": 1,
            "144": 1,
            "145": 1,
            "146": 1,
            "150": 1,
            "152": 1,
            "168": 1
        }
    },
    "name": "bush_epitope_A"
}
