{
    "default": 0,
    "output_type": "integer",
    "map": {
        "HA1": {
            "128": 1,
            "129": 1,
            "155": 1,
            "156": 1,
            "157": 1,
            "158": 1,
            "159": 1,
            "160": 1,
            "163": 1,
            "164": 1,
            "165": 1,
            "186": 1,
            "187": 1,
            "188": 1,
            "189": 1,
            "190": 1,
            "192": 1,
            "193": 1,
            "194": 1,
            "196": 1,
            "197": 1,
            "198": 1
        }
    },
    "name": "bush_epitope_B"
}
