{
    "default": 0,
    "output_type": "integer",
    "map": {
        "HA1": {
            "96": 1,
            "102": 1,
            "103": 1,
            "117": 1,
            "121": 1,
            "167": 1,
            "170": 1,
            "171": 1,
            "172": 1,
            "173": 1,
            "174": 1,
            "175": 1,
            "176": 1,
            "177": 1,
            "179": 1,
            "182": 1,
            "201": 1,
            "203": 1,
            "207": 1,
            "208": 1,
            "209": 1,
            "212": 1,
            "213": 1,
            "214": 1,
            "215": 1,
            "216": 1,
            "217": 1,
            "218": 1,
            "219": 1,
            "226": 1,
            "227": 1,
            "228": 1,
            "229": 1,
            "230": 1,
            "238": 1,
            "240": 1,
            "242": 1,
            "244": 1,
            "246": 1,
            "247": 1,
            "248": 1
        }
    },
    "name": "bush_epitope_D"
}
