{
    "default": 0,
    "output_type": "integer",
    "map": {
        "HA1": {
            "57": 1,
            "59": 1,
            "62": 1,
            "63": 1,
            "67": 1,
            "75": 1,
            "78": 1,
            "80": 1,
            "81": 1,
            "82": 1,
            "83": 1,
            "86": 1,
            "87": 1,
            "88": 1,
            "91": 1,
            "92": 1,
            "94": 1,
            "109": 1,
            "260": 1,
            "261": 1,
            "262": 1,
            "265": 1
        }
    },
    "name": "bush_epitope_E"
}
