{
    "default": 0,
    "map": {
        "HA1": {
            "145": 1,
            "155": 1,
            "156": 1,
            "158": 1,
            "159": 1,
            "189": 1,
            "193": 1
        }
    },
    "name": "koel"
}