{
    "default": 0,
    "map": {
        "HA1": {
            "50": 1,
            "53": 1,
            "54": 1,
            "121": 1,
            "122": 1,
            "124": 1,
            "126": 1,
            "131": 1,
            "133": 1,
            "135": 1,
            "137": 1,
            "142": 1,
            "143": 1,
            "144": 1,
            "145": 1,
            "146": 1,
            "155": 1,
            "156": 1,
            "157": 1,
            "158": 1,
            "159": 1,
            "160": 1,
            "163": 1,
            "164": 1,
            "172": 1,
            "173": 1,
            "174": 1,
            "186": 1,
            "188": 1,
            "189": 1,
            "190": 1,
            "192": 1,
            "193": 1,
            "196": 1,
            "197": 1,
            "201": 1,
            "207": 1,
            "213": 1,
            "217": 1,
            "226": 1,
            "227": 1,
            "242": 1,
            "244": 1,
            "248": 1,
            "275": 1,
            "276": 1,
            "278": 1,
            "299": 1,
            "307": 1
        }
    },
    "name": "luksza"
}