{
    "default": 0,
    "map": {
        "HA1": {
            "105": 1,
            "106": 1,
            "108": 1,
            "110": 1,
            "115": 1,
            "117": 1,
            "119": 1,
            "121": 1,
            "126": 1,
            "127": 1,
            "128": 1,
            "129": 1,
            "130": 1,
            "139": 1,
            "140": 1,
            "141": 1,
            "142": 1,
            "143": 1,
            "144": 1,
            "147": 1,
            "148": 1,
            "156": 1,
            "157": 1,
            "158": 1,
            "170": 1,
            "172": 1,
            "173": 1,
            "174": 1,
            "176": 1,
            "177": 1,
            "180": 1,
            "181": 1,
            "186": 1,
            "191": 1,
            "197": 1,
            "201": 1,
            "210": 1,
            "211": 1,
            "226": 1,
            "228": 1,
            "232": 1,
            "244": 1,
            "246": 1,
            "259": 1,
            "260": 1,
            "262": 1,
            "283": 1,
            "291": 1,
            "34": 1,
            "37": 1,
            "38": 1,
            "41": 1,
            "46": 1,
            "47": 1,
            "51": 1,
            "59": 1,
            "62": 1,
            "65": 1,
            "66": 1,
            "67": 1,
            "76": 1,
            "78": 1
        }
    },
    "name": "shih"
}