{
  "name": "Welsh et al. epitope sites",
  "default": 0,
  "map": {
    "HA1": {
      "50": 1,
      "82": 1,
      "124": 1,
      "135": 1,
      "137": 1,
      "143": 1,
      "144": 1,
      "145": 1,
      "157": 1,
      "159": 1,
      "189": 1,
      "193": 1,
      "275": 1,
      "276": 1
    }
  }
}