{
    "default": 0,
    "map": {
        "HA1": {
            "102": 1,
            "103": 1,
            "109": 1,
            "117": 1,
            "121": 1,
            "122": 1,
            "124": 1,
            "126": 1,
            "128": 1,
            "129": 1,
            "130": 1,
            "131": 1,
            "132": 1,
            "133": 1,
            "135": 1,
            "137": 1,
            "138": 1,
            "140": 1,
            "142": 1,
            "143": 1,
            "144": 1,
            "145": 1,
            "146": 1,
            "150": 1,
            "152": 1,
            "155": 1,
            "156": 1,
            "157": 1,
            "158": 1,
            "159": 1,
            "163": 1,
            "165": 1,
            "167": 1,
            "168": 1,
            "170": 1,
            "171": 1,
            "172": 1,
            "173": 1,
            "174": 1,
            "175": 1,
            "176": 1,
            "177": 1,
            "179": 1,
            "182": 1,
            "186": 1,
            "187": 1,
            "188": 1,
            "189": 1,
            "190": 1,
            "192": 1,
            "193": 1,
            "194": 1,
            "196": 1,
            "197": 1,
            "198": 1,
            "201": 1,
            "203": 1,
            "207": 1,
            "208": 1,
            "209": 1,
            "212": 1,
            "213": 1,
            "214": 1,
            "215": 1,
            "216": 1,
            "217": 1,
            "218": 1,
            "219": 1,
            "226": 1,
            "227": 1,
            "228": 1,
            "229": 1,
            "230": 1,
            "238": 1,
            "240": 1,
            "242": 1,
            "244": 1,
            "246": 1,
            "247": 1,
            "248": 1,
            "260": 1,
            "261": 1,
            "262": 1,
            "265": 1,
            "273": 1,
            "275": 1,
            "276": 1,
            "278": 1,
            "279": 1,
            "280": 1,
            "294": 1,
            "297": 1,
            "299": 1,
            "300": 1,
            "304": 1,
            "305": 1,
            "307": 1,
            "308": 1,
            "309": 1,
            "310": 1,
            "311": 1,
            "312": 1,
            "44": 1,
            "45": 1,
            "46": 1,
            "47": 1,
            "48": 1,
            "50": 1,
            "51": 1,
            "53": 1,
            "54": 1,
            "57": 1,
            "59": 1,
            "62": 1,
            "63": 1,
            "67": 1,
            "75": 1,
            "78": 1,
            "80": 1,
            "81": 1,
            "82": 1,
            "83": 1,
            "86": 1,
            "87": 1,
            "88": 1,
            "91": 1,
            "92": 1,
            "94": 1,
            "96": 1
        }
    },
    "name": "wolf"
}