{
    "default": 0,
    "map": {
        "NA": {
            "1": 1,
            "10": 1,
            "100": 1,
            "101": 1,
            "102": 1,
            "103": 1,
            "104": 1,
            "105": 1,
            "106": 1,
            "108": 1,
            "109": 1,
            "11": 1,
            "114": 1,
            "115": 1,
            "116": 1,
            "117": 1,
            "119": 1,
            "12": 1,
            "120": 1,
            "121": 1,
            "122": 1,
            "123": 1,
            "124": 1,
            "129": 1,
            "13": 1,
            "131": 1,
            "132": 1,
            "133": 1,
            "134": 1,
            "135": 1,
            "136": 1,
            "137": 1,
            "138": 1,
            "139": 1,
            "14": 1,
            "140": 1,
            "142": 1,
            "144": 1,
            "145": 1,
            "148": 1,
            "15": 1,
            "155": 1,
            "156": 1,
            "157": 1,
            "158": 1,
            "159": 1,
            "16": 1,
            "163": 1,
            "164": 1,
            "165": 1,
            "166": 1,
            "167": 1,
            "168": 1,
            "17": 1,
            "170": 1,
            "172": 1,
            "174": 1,
            "175": 1,
            "176": 1,
            "177": 1,
            "178": 1,
            "179": 1,
            "18": 1,
            "180": 1,
            "181": 1,
            "182": 1,
            "183": 1,
            "184": 1,
            "185": 1,
            "186": 1,
            "188": 1,
            "19": 1,
            "190": 1,
            "191": 1,
            "192": 1,
            "193": 1,
            "194": 1,
            "195": 1,
            "2": 1,
            "20": 1,
            "201": 1,
            "202": 1,
            "203": 1,
            "204": 1,
            "205": 1,
            "206": 1,
            "207": 1,
            "21": 1,
            "211": 1,
            "213": 1,
            "214": 1,
            "217": 1,
            "22": 1,
            "223": 1,
            "225": 1,
            "226": 1,
            "227": 1,
            "228": 1,
            "229": 1,
            "23": 1,
            "230": 1,
            "231": 1,
            "232": 1,
            "233": 1,
            "235": 1,
            "237": 1,
            "238": 1,
            "239": 1,
            "24": 1,
            "240": 1,
            "241": 1,
            "242": 1,
            "243": 1,
            "25": 1,
            "252": 1,
            "254": 1,
            "255": 1,
            "256": 1,
            "257": 1,
            "26": 1,
            "260": 1,
            "266": 1,
            "27": 1,
            "272": 1,
            "274": 1,
            "275": 1,
            "276": 1,
            "278": 1,
            "279": 1,
            "28": 1,
            "280": 1,
            "281": 1,
            "282": 1,
            "287": 1,
            "288": 1,
            "289": 1,
            "29": 1,
            "290": 1,
            "291": 1,
            "293": 1,
            "294": 1,
            "297": 1,
            "298": 1,
            "299": 1,
            "3": 1,
            "30": 1,
            "300": 1,
            "301": 1,
            "302": 1,
            "303": 1,
            "305": 1,
            "31": 1,
            "314": 1,
            "316": 1,
            "317": 1,
            "318": 1,
            "319": 1,
            "32": 1,
            "320": 1,
            "321": 1,
            "322": 1,
            "323": 1,
            "324": 1,
            "325": 1,
            "327": 1,
            "33": 1,
            "333": 1,
            "335": 1,
            "340": 1,
            "345": 1,
            "348": 1,
            "349": 1,
            "350": 1,
            "351": 1,
            "352": 1,
            "353": 1,
            "354": 1,
            "355": 1,
            "360": 1,
            "361": 1,
            "362": 1,
            "363": 1,
            "364": 1,
            "365": 1,
            "372": 1,
            "373": 1,
            "374": 1,
            "375": 1,
            "376": 1,
            "377": 1,
            "379": 1,
            "382": 1,
            "395": 1,
            "397": 1,
            "398": 1,
            "4": 1,
            "404": 1,
            "405": 1,
            "406": 1,
            "407": 1,
            "408": 1,
            "409": 1,
            "410": 1,
            "411": 1,
            "412": 1,
            "418": 1,
            "419": 1,
            "420": 1,
            "421": 1,
            "422": 1,
            "423": 1,
            "424": 1,
            "425": 1,
            "426": 1,
            "427": 1,
            "428": 1,
            "429": 1,
            "436": 1,
            "438": 1,
            "439": 1,
            "440": 1,
            "441": 1,
            "442": 1,
            "443": 1,
            "444": 1,
            "445": 1,
            "446": 1,
            "447": 1,
            "448": 1,
            "449": 1,
            "454": 1,
            "458": 1,
            "460": 1,
            "462": 1,
            "467": 1,
            "5": 1,
            "6": 1,
            "7": 1,
            "8": 1,
            "87": 1,
            "9": 1,
            "94": 1,
            "96": 1,
            "97": 1,
            "98": 1,
            "99": 1
        }
    },
    "name": "bhatt_nonepitope"
}