{
    "default": 0,
    "map": {
        "NA": {
            "107": 1,
            "110": 1,
            "111": 1,
            "112": 1,
            "113": 1,
            "118": 1,
            "125": 1,
            "126": 1,
            "127": 1,
            "128": 1,
            "130": 1,
            "141": 1,
            "143": 1,
            "146": 1,
            "147": 1,
            "149": 1,
            "150": 1,
            "151": 1,
            "152": 1,
            "153": 1,
            "154": 1,
            "160": 1,
            "161": 1,
            "162": 1,
            "169": 1,
            "171": 1,
            "173": 1,
            "187": 1,
            "189": 1,
            "196": 1,
            "197": 1,
            "198": 1,
            "199": 1,
            "200": 1,
            "208": 1,
            "209": 1,
            "210": 1,
            "212": 1,
            "215": 1,
            "216": 1,
            "218": 1,
            "219": 1,
            "220": 1,
            "221": 1,
            "222": 1,
            "224": 1,
            "234": 1,
            "236": 1,
            "244": 1,
            "245": 1,
            "246": 1,
            "247": 1,
            "248": 1,
            "249": 1,
            "250": 1,
            "251": 1,
            "253": 1,
            "258": 1,
            "259": 1,
            "261": 1,
            "262": 1,
            "263": 1,
            "264": 1,
            "265": 1,
            "267": 1,
            "268": 1,
            "269": 1,
            "270": 1,
            "271": 1,
            "273": 1,
            "277": 1,
            "283": 1,
            "284": 1,
            "285": 1,
            "286": 1,
            "292": 1,
            "295": 1,
            "296": 1,
            "304": 1,
            "306": 1,
            "307": 1,
            "308": 1,
            "309": 1,
            "310": 1,
            "311": 1,
            "312": 1,
            "313": 1,
            "315": 1,
            "326": 1,
            "328": 1,
            "329": 1,
            "330": 1,
            "331": 1,
            "332": 1,
            "334": 1,
            "336": 1,
            "337": 1,
            "338": 1,
            "339": 1,
            "34": 1,
            "341": 1,
            "342": 1,
            "343": 1,
            "344": 1,
            "346": 1,
            "347": 1,
            "35": 1,
            "356": 1,
            "357": 1,
            "358": 1,
            "359": 1,
            "36": 1,
            "366": 1,
            "367": 1,
            "368": 1,
            "369": 1,
            "37": 1,
            "370": 1,
            "371": 1,
            "378": 1,
            "38": 1,
            "380": 1,
            "381": 1,
            "383": 1,
            "384": 1,
            "385": 1,
            "386": 1,
            "387": 1,
            "388": 1,
            "389": 1,
            "39": 1,
            "390": 1,
            "391": 1,
            "392": 1,
            "393": 1,
            "394": 1,
            "396": 1,
            "399": 1,
            "40": 1,
            "400": 1,
            "401": 1,
            "402": 1,
            "403": 1,
            "41": 1,
            "413": 1,
            "414": 1,
            "415": 1,
            "416": 1,
            "417": 1,
            "42": 1,
            "43": 1,
            "430": 1,
            "431": 1,
            "432": 1,
            "433": 1,
            "434": 1,
            "435": 1,
            "437": 1,
            "44": 1,
            "45": 1,
            "450": 1,
            "451": 1,
            "452": 1,
            "453": 1,
            "455": 1,
            "456": 1,
            "457": 1,
            "459": 1,
            "46": 1,
            "461": 1,
            "463": 1,
            "464": 1,
            "465": 1,
            "466": 1,
            "468": 1,
            "469": 1,
            "47": 1,
            "48": 1,
            "49": 1,
            "50": 1,
            "51": 1,
            "52": 1,
            "53": 1,
            "54": 1,
            "55": 1,
            "56": 1,
            "57": 1,
            "58": 1,
            "59": 1,
            "60": 1,
            "61": 1,
            "62": 1,
            "63": 1,
            "64": 1,
            "65": 1,
            "66": 1,
            "67": 1,
            "68": 1,
            "69": 1,
            "70": 1,
            "71": 1,
            "72": 1,
            "73": 1,
            "74": 1,
            "75": 1,
            "76": 1,
            "77": 1,
            "78": 1,
            "79": 1,
            "80": 1,
            "81": 1,
            "82": 1,
            "83": 1,
            "84": 1,
            "85": 1,
            "86": 1,
            "88": 1,
            "89": 1,
            "90": 1,
            "91": 1,
            "92": 1,
            "93": 1,
            "95": 1
        }
    },
    "name": "bhatt"
}