{
    "default": 0,
    "map": {
        "NA": {
            "197": 1,
            "198": 1,
            "199": 1,
            "200": 1,
            "221": 1,
            "222": 1,
            "328": 1,
            "329": 1,
            "330": 1,
            "331": 1,
            "332": 1,
            "334": 1,
            "336": 1,
            "338": 1,
            "339": 1,
            "341": 1,
            "342": 1,
            "343": 1,
            "344": 1,
            "346": 1,
            "347": 1,
            "357": 1,
            "358": 1,
            "359": 1,
            "366": 1,
            "367": 1,
            "368": 1,
            "369": 1,
            "370": 1,
            "383": 1,
            "384": 1,
            "385": 1,
            "386": 1,
            "387": 1,
            "389": 1,
            "390": 1,
            "391": 1,
            "392": 1,
            "393": 1,
            "394": 1,
            "396": 1,
            "399": 1,
            "400": 1,
            "401": 1,
            "403": 1
        }
    },
    "name": "munoz"
}