{
    "default": 0,
    "map": {
        "HA1": {
            "124": 1,
            "125": 1,
            "137": 1,
            "138": 1,
            "139": 1,
            "140": 1,
            "141": 1,
            "142": 1,
            "153": 1,
            "154": 1,
            "155": 1,
            "156": 1,
            "157": 1,
            "159": 1,
            "160": 1,
            "161": 1,
            "162": 1,
            "163": 1,
            "164": 1,
            "166": 1,
            "167": 1,
            "168": 1,
            "169": 1,
            "170": 1,
            "184": 1,
            "185": 1,
            "186": 1,
            "187": 1,
            "188": 1,
            "189": 1,
            "190": 1,
            "191": 1,
            "192": 1,
            "193": 1,
            "194": 1,
            "195": 1,
            "203": 1,
            "204": 1,
            "205": 1,
            "221": 1,
            "222": 1,
            "235": 1,
            "236": 1,
            "237": 1,
            "70": 1,
            "71": 1,
            "72": 1,
            "73": 1,
            "74": 1,
            "75": 1
        }
    },
    "name": "canton"
}